98888888888888888889
80000000000000000008
80900090000009000908
80801080000008010808
80988890090009888908
8000000093B900000058
820000009A3900000008
80988890009009888908
80801080000008010808
80900090000009000908
80000000000000000008
98888888888888888889