98888888888888888889
71107000000000070037
71107000000000070007
70000000000000000007
98800000900900000889
700000007117000000A7
700000007117000000B7
78800000988900000889
70000000000000000007
70007000000000700007
72007000000000700057
98889888888888988889