98898888888888888889
70070000030001100007
70070000000001100007
70098888888888900007
70000000000000000007
70009890989888900007
70107000007000000007
70007000007001001007
705070020070C0000d07
70007000007000010007
70007000007000000007
98889888889888888889
