00998888888888888889
09900000000000000007
99000000000000000007
90309888888898909779
70007000000000700007
70007098888888988907
70007000000000700007
70009888888890709779
70007000000000700007
97707098888888988907
75007000000000700007
98889888888888988889