98888898888888898899
71000090001000990379
70000099000009900079
70000009900009000079
70009900990099000079
70999000000990000079
99900000000000099179
70000000900000009979
70000999000009900999
70209900010000990009
98889888888888899059
99999999999999999999

