98888888888888888889800000000000000000088090009000000900090880801080000008010808809888900900098889088000000093B900000058820000009A39000000088098889000900988890880801080000008010808809000900000090009088000000000000000000898888888888888888889
9888888888888888888971107000000000070037711070000000000700077000000000000000000798800000900900000889700000007117000000A7700000007117000000B77880000098890000088970000000000000000007700070000000007000077200700000000070005798889888888888988889
9889888888888888888970070000030001100007700700000000011000077009888888888890000770000000000000000007700098909898889000077010700000700000000770007000007001001007705070020070C0000d07700070000070000100077000700000700000000798889888889888888889
009988888888888888890990000000000000000799000000000000000007903098888888989097797000700000000070000770007098888888988907700070000000007000077000988888889070977970007000000000700007977070988888889889077500700000000070000798889888888888988889
988888988888888988997100009000100099037970000099000009900079700000099000090000797000990099009900007970999000000990000079999000000000000991797000000090000000997970000999000009900999702099000100009900099888988888888889905999999999999999999999


